title:Level 2
lurd:ulldldrrrdrruldluuu
   ###
 ###.#
##   #
# X#@###
#      #
####   #
   #####