title:Level 7
lurd:dlllldllurrrrurdddldddrruulrddlluurulldlurull
    #####
#####  @#
# X     #
#.   # ##
###    ##
  #     #
  ### # #
    #   #
    #####