title:Level 8
lurd:lluuurulddddrruulrddlluu
#####
#.  #
##. ##
## X #
# X# #
#   @#
######